"""                          
....................
....................
...........S.M......
..........FFFF......
....................
..T..P..............
GGGGGGG.............
DDDDDDD....R..B.....
DDDDDDDGGGGGGGGG..H.
DDDDDDDDDDDDDDDDGGGG"""